14
14
1
1













