18
19
1
1








TEST









